8 4 2 8 4 8 7 5
3 2 4 5 1 7 8 6
5 3 7 4 5 6 4 1
7 5 5 1 6 3 4 3
5 1 2 4 7 5 2 8
8 7 3 2 2 8 5 5
2 6 6 8 7 4 5 3
7 4 1 2 6 5 6 7
