1 7 3 6 5 2 4
1 6 1 5 3 1 1
4 2 5 6 2 1 2
1 5 2 1 6 7 3
5 5 1 3 2 3 4
7 3 4 2 6 6 5
6 1 6 7 7 5 4
